1 1 1 1 1 1 1 1 1 1
1 0 0 0 0 0 0 0 0 1
1 0 0 0 0 0 0 0 0 1
1 0 0 0 0 0 0 0 0 1
1 0 0 0 0 0 0 0 0 1
1 0 0 0 0 0 0 0 0 1
1 8 6 0 0 0 0 0 0 1
1 0 0 0 7 0 0 0 0 1
1 0 0 0 8 0 0 0 0 1
1 1 1 1 1 1 1 1 1 1