1 1 1 1 2 1 1 1 1 1
1 0 0 0 0 0 0 0 0 1
1 0 10 0 0 0 0 0 0 1
1 0 0 0 0 0 9 0 0 1
1 0 0 0 0 0 0 0 0 4
3 0 0 0 0 0 0 0 0 1
1 0 0 0 0 8 8 0 0 1
1 0 0 0 0 0 0 0 0 1
1 0 0 0 0 0 0 0 0 1
1 1 1 1 1 5 1 1 1 1