1 1 1 1 1 1 1 1 1 1 1 1 1 1 1 1 1 1 1 1 1 1 1 1 1 1 1 1 1 1
1 0 0 0 0 0 0 0 0 0 0 0 0 0 0 0 0 0 0 0 0 0 0 0 0 0 0 1 1 1
1 4 4 4 4 4 4 4 4 4 4 4 4 4 2 4 4 4 4 4 4 4 4 4 4 4 4 4 4 1
1 7 0 0 0 0 0 0 0 0 8 8 8 0 9 0 0 8 8 0 0 0 0 0 0 0 0 0 7 1
1 7 0 0 0 9 0 0 0 0 8 8 4 4 0 4 4 8 8 0 0 0 0 0 0 0 0 0 7 1
1 7 0 0 5 10 5 0 0 0 0 0 2 10 0 10 2 0 0 0 0 0 0 0 0 0 0 0 7 1
1 7 0 0 5 2 5 0 0 0 0 0 4 4 0 4 4 0 0 0 0 0 0 0 0 0 0 0 7 1
1 7 0 0 5 10 5 0 0 25 0 0 2 10 9 10 2 0 0 0 0 0 0 0 0 0 0 0 7 1
1 7 0 0 0 9 0 0 0 0 0 0 4 4 0 4 4 0 0 0 0 0 0 0 0 0 0 0 7 1
1 7 0 0 0 0 0 0 0 0 0 0 2 10 0 10 2 0 0 0 0 0 0 0 0 0 0 0 7 1
1 7 7 7 7 7 7 7 7 7 7 7 4 4 2 4 4 7 7 7 7 7 7 7 7 7 7 7 7 1
1 1 1 1 1 1 1 1 1 1 1 1 1 1 1 1 1 1 1 1 1 1 1 1 1 1 1 1 1 1
