1 1 1 1 1 1 1 1 1 1 1 1 1 1 1 1 1 1 1 1 1 1 1 1 1 1 1 1 1 1
1 10 1 0 0 0 0 0 0 1 0 4 0 0 0 0 0 0 0 0 0 0 0 0 0 0 0 0 0 1
1 0 0 0 0 0 0 2 0 0 0 4 0 0 0 0 0 0 0 0 0 0 0 0 0 0 0 0 0 1
1 0 1 0 0 0 0 0 0 1 0 4 0 0 0 0 0 0 0 0 0 0 0 0 0 0 0 0 0 1
1 9 1 0 0 0 0 0 0 1 0 4 0 0 0 0 0 0 0 0 2 2 0 0 0 0 0 0 0 1
1 8 1 1 1 1 1 1 1 1 0 4 0 0 0 0 0 0 0 0 8 2 0 0 0 0 0 0 0 1
1 0 1 0 0 0 0 0 0 0 0 4 0 0 0 0 0 0 0 0 10 0 0 0 0 0 0 0 0 1
1 0 0 0 9 0 0 0 4 4 4 4 0 0 0 0 0 0 0 0 9 0 0 0 0 0 0 0 0 1
1 0 1 0 0 0 0 0 9 0 0 0 0 0 0 0 0 0 0 0 0 0 0 0 0 0 0 0 0 1
1 1 1 1 1 1 1 1 1 1 1 1 1 1 1 1 1 1 1 1 1 1 1 1 1 1 1 1 1 1
